|------------------------------------------------|
|                World Traveller                 |
|------------------------------------------------|
| +--------------------------------------------+ |
| |                Start                       | |
| +--------------------------------------------+ |
|                    |                           |
|                    v                           |
| +--------------------------------------------+ |
| |         Register Customer                  | |
| +--------------------------------------------+ |
|                    |                           |
|                    v                           |
| +--------------------------------------------+ |
| |      Record Customer Requirements          | |
| +--------------------------------------------+ |
|                    |                           |
|                    v                           |
| +--------------------------------------------+ |
| |     Refer to Flight Timetables             | |
| +--------------------------------------------+ |
|                    |                           |
|                    v                           |
| +--------------------------------------------+ |
| |     Refer to Hotel Locations               | |
| +--------------------------------------------+ |
|                    |                           |
|                    v                           |
| +--------------------------------------------+ |
| |     Refer to Holiday Agencies              | |
| +--------------------------------------------+ |
|                    |                           |
|                    v                           |
| +--------------------------------------------+ |
| |   Match Customer Requirements              | |
| +--------------------------------------------+ |
|                    |                           |
| +------------------|-------------------------+ |
| |                  v                         | |
| | +----------------------------------------+ | |
| | | Advise on Alternatives                | | |
| | +----------------------------------------+ | |
| |                  |                         | |
| +------------------|-------------------------+ |
|                    v                           |
| +--------------------------------------------+ |
| |         Make Bookings                     | |
| +--------------------------------------------+ |
|                    |                           |
| +------------------|-------------------------+ |
| |                  v                         | |
| | +----------------------------------------+ | |
| | | Organize Holiday Insurance            | | |
| | +----------------------------------------+ | |
| |                  |                         | |
| +------------------|-------------------------+ |
|                    v                           |
| +--------------------------------------------+ |
| |       Organize Car Hire                   | |
| +--------------------------------------------+ |
|                    |                           |
|                    v                           |
| +--------------------------------------------+ |
| |        Print Itinerary                    | |
| +--------------------------------------------+ |
|                    |                           |
|                    v                           |
| +--------------------------------------------+ |
| |       Customer Accepts Itinerary          | |
| +--------------------------------------------+ |
|                    |                           |
|                    v                           |
| +--------------------------------------------+ |
| |           Bill Customer                   | |
| +--------------------------------------------+ |
|                    |                           |
| +------------------|-------------------------+ |
| |                  v                         | |
| | +----------------------------------------+ | |
| | |  Complete Payment                      | | |
| | +----------------------------------------+ | |
| |                  |                         | |
| | +----------------|-----------------------+ | |
| | |                v                       | | |
| | | +------------------------------------+ | | |
| | | |  Receive Deposit                   | | | |
| | | +------------------------------------+ | | |
| | |                |                       | | |
| | |                v                       | | |
| | | +------------------------------------+ | | |
| | | |  Add Credit Card Commission        | | | |
| | | +------------------------------------+ | | |
| | |                |                       | | |
| | |                v                       | | |
| | | +------------------------------------+ | | |
| | | |  Receive Receipt                   | | | |
| | | +------------------------------------+ | | |
| |                |                         | |
| +----------------|-------------------------+ |
|                  |                           |
|                  v                           |
| +--------------------------------------------+ |
| |                 End                        | |
| +--------------------------------------------+ |
|------------------------------------------------|
